Kata ganti dalam bahasa Jepang, atau "daimeishi" (代名詞), adalah kata yang menggantikan atau mewakili orang, benda, atau hal lain dalam percakapan. Penggunaan kata ganti membantu menghindari pengulangan kata-kata tertentu dan membuat percakapan lebih efisien. Kata ganti dapat digunakan untuk mengacu pada diri sendiri (orang pertama), orang lain (orang kedua atau ketiga), atau benda dan konsep lainnya.

Kata Ganti Orang:
Orang Pertama: Kata ganti untuk merujuk pada diri sendiri, misalnya "私" (watashi) atau "僕" (boku).
Orang Kedua: Kata ganti untuk merujuk pada lawan bicara, misalnya "あなた" (anata).
Orang Ketiga: Kata ganti untuk merujuk pada orang atau benda di luar pembicara dan pendengar, misalnya "彼" (kare) atau "彼女" (kanojo).

Orang Pertama Tunggal:
私 (Watashi) - Saya (umum, netral)
僕 (Boku) - Saya (digunakan oleh pria, sedikit lebih kasual)
俺 (Ore) - Saya (digunakan oleh pria, kasual, sedikit kasar)
自分 (Jibun) - Saya (lebih formal)
余 (Yo) - Saya (sangat formal, jarang digunakan)
あたし (Atashi) - Saya (digunakan oleh wanita, kasual)
わたくし (Watakushi) - Saya (sangat formal)
うち (Uchi) - Saya (digunakan oleh wanita, di wilayah tertentu)

Orang Kedua Tunggal:
あなた (Anata) - Anda (umum, netral)
君 (Kimi) - Anda (lebih kasual, digunakan oleh laki-laki untuk perempuan atau antara teman)
お前 (Omae) - Anda (kasual, bisa terdengar kasar)
貴様 (Kisama) - Anda (kasar, tidak sopan)
てめえ (Temee) - Anda (sangat kasar)
お前さん (Omaesan) - Anda (kasual, sedikit lebih sopan daripada "omae")
君たち (Kimitachi) - Kalian (bentuk jamak dari "kimi")
お前たち (Omaetachi) - Kalian (bentuk jamak dari "omae")

Orang Ketiga Tunggal:
彼 (Kare) - Dia (laki-laki)
彼女 (Kanojo) - Dia (perempuan)
あの人 (Anohito) - Dia (netral, lebih formal)
その人 (Sonohito) - Dia (netral, sedikit lebih formal)
あの方 (Anokata) - Dia (sangat formal, sopan)
その方 (Sonokata) - Dia (sangat formal, sedikit lebih sopan)
あれ (Are) - Itu (netral)
それ (Sore) - Itu (netral)
あちら (Achira) - Itu (lebih formal)
どれ (Dore) - Itu (tanya yang mana)

Orang Pertama Jamak:
私たち (Watashitachi) - Kami (netral)
僕ら (Bokura) - Kami (digunakan oleh pria, lebih kasual)
我々 (Wareware) - Kami (lebih formal)
うちら (Uchira) - Kami (digunakan oleh wanita)

Orang Kedua Jamak:
あなたたち (Anatatachi) - Kalian (netral)
君たち (Kimitachi) - Kalian (lebih kasual, jamak dari "kimi")
お前たち (Omaetachi) - Kalian (kasual, jamak dari "omae")

Orang Ketiga Jamak:
彼ら (Karera) - Mereka (laki-laki)
彼女ら (Kanojora) - Mereka (perempuan)
あの人たち (Anohitotachi) - Mereka (netral)
あの方々 (Anokatagata) - Mereka (sangat formal, sopan)
あれら (Arera) - Itu (netral, jamak)
それら (Sorera) - Itu (netral, jamak)
あちら (Achira) - Itu (lebih formal, jamak)
どれら (Dorera) - Itu (tanya yang mana, jamak)

Kata Ganti Lainnya:
この (Kono) - Ini
その (Sono) - Itu
あの (Ano) - Itu (jauh)
どの (Dono) - Yang mana (tanya)
こちら (Kochira) - Ini (lebih formal)
そちら (Sochira) - Itu (lebih formal)
あちら (Achira) - Itu (lebih formal)
どちら (Dochira) - Yang mana (lebih formal)

Kata Ganti Benda:
Kata ganti untuk merujuk pada benda atau hal lainnya, misalnya "これ" (kore) untuk "ini" atau "それ" (sore) untuk "itu".
