Kata benda dalam bahasa Jepang dikenal sebagai "名詞" (meishi). Ini mencakup segala sesuatu dari benda, tempat, orang, atau konsep yang dapat diidentifikasi atau dirujuk dalam percakapan. Berikut adalah beberapa contoh kata benda dalam bahasa Jepang:

Musim:
Musim : 季節 (Kisetsu)
Musim semi : 春 (Haru)
Musim panas : 夏 (Natsu)
Musim gugur : 秋 (Aki)
Musim dingin : 冬 (Fuyu)

Cuaca:
Cuaca : 天気 (Tenki)
Cerah : 晴れ (Hare)
Mendung : 曇り (Kumori)
Hujan : 雨 (Ame)
Salju : 雪 (Yuki)
Angin : 風 (Kaze)
Panas : 暑い (Atsui)
Dingin : 寒い (Samui)

Hewan:
Hewan : 動物 (Doubutsu)
Kucing : 猫 (Neko)
Harimau : 虎 (Tora)
Singa : 獅子 (Shishi)
Anjing : 犬 (Inu)
Burung : 鳥 (Tori)
Ikan : 魚 (Sakana)
Monyet : 猿 (Saru)
Gajah : 象 (Zou)
Sapi : 牛 (Ushi)
Kuda : 馬 (Uma)
Domba : 羊 (Hitsuji)
Babi : 豚 (Buta)
Ayam : 鶏 (Niwatori)
Beruang : 熊 (Kuma)
Kelinci : 兎 (Usagi)
Kupu-kupu : 蝶 (Chou)
Semut : 蟻 (Ari)
Gurita : 蛸 (Tako)
Cumi-cumi : 烏賊 (Ika)
Tuna : 鮪 (Maguro)
Udang : 海老 (Ebi)
Kepiting : 蟹 (Kani)
Penguin : ペンギン (Pengin)
Lebah : 蜜蜂 (Hachi)
Tikus : 鼠 (Nezumi)

Tempat Umum:
Tempat Umum : 公共の場所 (Koukyou no basho)
Bank : 銀行 (Ginkou)
Rumah Sakit : 病院 (Byouin)
Supermarket : スーパー (Suupaa)
Taman : 公園 (Kouen)
Sekolah : 学校 (Gakkou)
Restoran : レストラン (Resutoran)
Bioskop : 映画館 (Eigakan)
Bandara : 空港 (Kuukou)
Stasiun : 駅 (Eki)
Perpustakaan : 図書館 (Toshokan)
Hotel : ホテル (hoteru)
Cafe : 喫茶店 (kissaten)
Museum seni : 美術館 (bijutsukan)
Pasar : 市場 (ichiba)
Street Food : 屋台食べ物 (yataitabemono)

Anggota Tubuh:
Anggota Tubuh : 手足 (teashi)
Kepala : 頭 (atama)
Mata : 目 (me)
Hidung : 鼻 (hana)
Mulut : 口 (kuchi)
Telinga : 耳 (mimi)
Rambut : 髪の毛 (kami no ke)
Wajah : 顔 (kao)
Leher : 首 (kubi)
Lengan : 腕 (ude)
Tangan : 手 (te)
Jari : 指 (yubi)
Kaki : 足 (ashi)
Jempol kaki : 足の親指 (ashi no oyayubi)
Punggung : 背中 (senaka)
Perut : 腹 (hara)
Dada : 胸 (mune)
Pinggang : 腰 (koshi)
Paha : 腿 (momogashira)
Lutut : 膝 (hiza)
Kaki : 脚 (ashi)
Tumit : かかと (kakato)
Bahu : 肩 (kata)